C 0,255,255
SO     ./textures/the_starry_night.png
WE      ./textures/girl_with_a_pearl_earring.png
EA       ./textures/Impression_Sunrise.png
F 0,  255,   0
NO ./textures/Mona_Lisa.png



       11111111111111111111111111111111111111111111111111111111111111111111111111
       100000000000000000000000000000000000000000000000000000000000000000000001
       100000000000000000000000000000000000000000000000000000000000000000000001
       100000000000000000000000000000000000000000000000000000000000000000000001
       100000000000000000000000000000000000000000000000000000000000000000000001
       100000000000000000000000000000000000000000000000000000000000000000000001
       100000000000000000000000000000000000000000000000000000000000000000000001
       100000000000000000000000000000000000000000000000000000000000000000000001
       100000000000000000000000000000000000000000000000000000000000000000000001
       100000000000000000000000000000000000000000000000000000000000000000000001
       100000000000000000000000000000000000000000000000000000000000000N00000001
       100000000000000000000000000000000000000000000000000000000000000000000001
       100000000000000000000000000000000000000000000000000000000000000000000001
       100000000000000000000000000000000000000000000000000000000000000000000001
       100000000000000000000000000000000000000000000000000000000000000000000001
       100000000000000000000000000000000000000000000000000000000000000000000001
       100000000000000000000000000000000000000000000000000000000000000000000001
       100000000000000000000000000000000000000000000000000000000000000000000001    11111
       100000000000000000000000000000000000000000000000000000000000000000000001   11111
       100000000000000000000000000000000000000000000000000000000000000000000001    11011
       11111111111111111111111111111111111111111111111111111
