NO ./m2
SO ./m3
WE ./m4
EA ./m5

C 135,206,0
F 102,0,0
1111111111111111111111 1111111
10000000001100000000001000001
10110000011100000000000010001
1001000000000000000N0000010001
10110000011100000000000010001
10000000001100000111011110001
11110111111111011100000010001
11110111111111011101010010001
11000000110101011100000010001
10000000000000001100000010001
10000000000000001101010010001
11000000110101000000000000001
11110111110101000000000000001
10000000001100000100000010001
10000000000000001010000101001
10000000001000010001010001001
10000000001101000000000000001
10000000000100000001010000001
11111111111111111111111111111