C 0,255,255
SO     ./textures/seamless_stone.png
WE      ./textures/seamless_stone.png
EA       ./textures/seamless_stone.png
F 0,  255,   0
NO ./textures/seamless_stone.png



       111111111111111111111111111111111111111111111111111111111111111111111111
       100000011110000000000000000000000000000000010000000000000100000000000001
       100000000010000000000000000000000000000000010000000000000111000000000001
       100000000010000000000000000000000000000000010000000000000111000000000001
       100000000010000000000000000000000000000000010000000000000111000000000001
       1000000000D0000000000000000000000000000000010000000000000111000000000001
       1000000000100000000000000000000W0000000000010000000000000111000000000001
       1000000000110000000000000000000000000000000D0000000000000111100000000001
       100000000011111111000000000000000000000000010000000000001000000000000001
       100000000000000001000000000000000000000000010000000000000100000000000001
       100000000000000001000000000000000000000000011111111D11111111111111111111
       100000000000000001000000000000000000000000010000000000000100000000000001
       10000000000000000D000000000000000000000000010000000000000100000000000001
       100000000000000001000000000000000000000000010000000000000100000000000001
       1000000000000000010000000000000000000000000D0000000000000100000000000001
       100000000000000001000000000000000000000000010000000000000D00000000000001
       100000000000000001000000000000000000000000010000000000000100000000000001
       100000000000000001000000000000000000000000010000000000000100000000000001    11111
       100000000000000001000000000000000000000000010000000000000100000000000001   11111
       100000000000000001000000000000000000000000010000000000000100000000000001    11011
       111111111111111111111111111111111111111111111111111111111111111111111111
