NO ./m2
SO ./m3
WE ./m4
EA ./m5

C 135,206,0
F 102,0,0
111111111111111111111111111111111111111111111111111111111111
1000000000000000000000000000000000000000000000000000000000001
1011000001110000000000001000000000000000000000000000000000011
1000000000110000011101D11000000000010000000000000000000000011
1111011111111101110000001000000000000000000000000000000000011
1111011111111101110101001000000000000000000000000000000000011
1100000011010101110000001000N00000000000000000000000000000011
1111111D11111111111111111111D11111111111111111111111111D11111
1000000000000000110101001000000000000000000000000000000000011
1100000011010100000000000000000000000000000000000000000000011
1111011111010100000000000000000000000000000000000000000000011
1000000000110000010000001000000000000000000000000000000000011
1000000000000000101000010100000000000000000000000000000000011
1000000000100001000101000100000000000000000000000000000000011
1000000000110100000000000000000000000000000000000000000000011
1000000000010000000101000000000000000000000000000000000000011
1100000011010101110000001000000000000000000000000000000000011
1000000000000000110000001000000000000000000000000000000000011
1000000000000000110101001000000000000000000000000000000000011
1100000011010100000000000000000000000000000000000000000000011
1111011111010100000000000000000000000000000000000000000000011
1000000000110000010000001000000000000000000000000000000000011
1000000000000000101000010100000000000000000000000000000000011
1000000000100001000101000100000000000000000000000000000000011
1000000000110100000000000000000000000000000000000000000000011
1000000000010000000101000000000000000000000000000000000000011
1100000011010101110000001000000000000000000000000000000000011
1000000000000000110000001000000000000000000000000000000000011
1000000000000000110101001000000000000000000000000000000000011
1100000011010100000000000000000000000000000000000000000000011
1111011111010100000000000000000000000000000000000000000000011
1000000000110000010000001000000000000000000000000000000000011
1000000000000000101000010100000000000000000000000000000000011
1000000000100001000101000100000000000000000000000000000000011
1000000000110100000000000000000000000000000000000000000000011
1000000000010000000101000000000000000000000000000000000000011
1100000011010101110000001000000000000000000000000000000000011
1000000000000000110000001000000000000000000000000000000000011
1000000000000000110101001000000000000000000000000000000000011
1100000011010100000000000000000000000000000000000000000000011
1111011111010100000000000000000000000000000000000000000000011
1000000000110000010000001000000000000000000000000000000000011
1000000000000000101000010100000000000000000000000000000000011
1000000000100001000101000100000000000000000000000000000000011
1000000000110100000000000000000000000000000000000000000000011
1000000000010000000101000000000000000000000000000000000000011
1100000011010101110000001000000000000000000000000000000000011
1000000000000000110000001000000000000000000000000000000000011
1000000000000000110101001000000000000000000000000000000000011
1100000011010100000000000000000000000000000000000000000000011
1111011111010100000000000000000000000000000000000000000000011
1000000000110000010000001000000000000000000000000000000000011
1000000000000000101000010100000000000000000000000000000000011
1000000000100001000101000100000000000000000000000000000000011
1000000000110100000000000000000000000000000000000000000000011
1000000000010000000101000000000000000000000000000000000000011
1100000011010101110000001000000000000000000000000000000000011
1000000000000000110000001000000000000000000000000000000000011
1000000000000000110101001000000000000000000000000000000000011
1100000011010100000000000000000000000000000000000000000000011
1111011111010100000000000000000000000000000000000000000000011
1000000000110000010000001000000000000000000000000000000000011
1000000000000000101000010100000000000000000000000000000000011
1000000000100001000101000100000000000000000000000000000000011
1000000000110100000000000000000000000000000000000000000000011
1000000000010000000101000000000000000000000000000000000000011
1111111111111111111111111111111111111111111111111111111111111