NO ./m2
SO ./m3
WE ./m4
EA ./m5

C 135,206,0
F 102,0,0

       1111
       1001
       10N1
       1111
