NO ./path_to_the_north_texture
SO ./path_to_the_south_texture
WE ./path_to_the_west_texture
EA ./path_to_the_east_tex
F 220,255,0
C 225,6,2

   1111111111111111
  1100001D1000N0000011
 1100000000000000111
  100000001111000011
 1111111111   111111
